1606798800,1173795,
1609477200,1177681,
1612155600,1182101,
1614574800,1186361,
1617249600,1193121,
1619841600,1198922,
1622520000,1204374,1
